// 色、　影の色
#000,#888,
#fff,#888,
#ccc,#fff,
#888,#fff,
#f00,#888,
#ff0,#888,
#0f0,#888,
#0ff,#888,
#00f,#888,
#f0f,#888,
#800,#ccc,
#880,#ccc,
#080,#ccc,
#088,#ccc,
#008,#ccc,
#808,#ccc,
#f88,#888,
#ff8,#888,
#8f8,#888,
#8ff,#888,
#88f,#888,
#f8f,#888,
