// 色、　影の色
#000,#888,
#fff,#888,
#ccc,#fff,
#888,#fff,
#800,#888,
#808,#888,
#f0f,#888,
#f00,#888,
#080,#888,
#0f0,#888,
#880,#888,
#ff0,#888,
#008,#888,
#00f,#888,
#088,#888,
#0ff,#888,
